*********
*.*.*-*-.
*.*.*-*-*
*...*-*-*
*.***-*-*
*-----*-*
*-*****-*
*-------*
*********
