*********
*.*.*.*..
*.*.*.*.*
*...*.*.*
*.***.*.*
*.....*.*
*.*****.*
*.......*
*********